00 07 07 07 07 07 07 07 07 07 07 07 07 07 07 01
12 16 19 19 19 19 19 19 19 19 19 19 19 19 16 12
12 17 16 16 16 16 16 18 16 16 16 16 16 16 16 12
12 17 16 16 16 16 16 16 16 16 16 16 16 16 16 12
12 17 16 16 16 16 16 16 16 16 16 16 16 16 16 12
12 17 16 16 16 16 16 16 16 16 16 16 16 16 16 12
02 07 07 07 07 07 07 07 07 07 07 07 07 07 07 03