00 07 07 07 07 07 07 07 07 07 07 07 07 07 07 01
12 15 19 19 19 19 19 19 19 19 19 19 19 19 15 12
12 16 16 16 16 16 16 18 16 16 16 16 16 16 16 12
12 16 16 16 16 16 16 16 16 16 16 16 16 16 16 12
12 16 16 16 16 16 16 16 16 16 16 16 16 16 16 12
12 16 16 16 16 16 16 16 16 16 16 16 16 16 16 12
02 07 07 07 07 07 07 07 07 07 07 07 07 07 07 03