12 16
15 15 15 15 15 15 15 15 15 15 15 15 15 15 15 15
00 07 07 07 07 07 07 07 07 07 07 07 07 07 07 01
12 16 16 16 16 18 16 16 16 16 16 16 16 16 16 12
12 16 16 16 16 16 16 16 16 16 16 16 16 16 16 12
12 16 16 16 16 16 16 16 16 16 16 16 16 16 16 12
12 16 16 16 16 16 16 16 16 16 16 16 16 16 16 12
11 07 07 07 07 07 07 09 16 05 07 07 07 07 17 13
12 16 16 16 16 16 16 16 16 16 16 16 16 16 17 12
12 16 16 16 16 16 16 16 16 16 16 16 16 16 17 12
12 16 16 16 16 16 16 16 16 16 16 16 16 16 17 12
12 16 16 16 16 16 16 16 16 16 16 16 16 16 17 12
02 07 07 07 07 07 07 07 07 07 07 07 07 07 07 03
1 80 120 
1 280 160
1
EXIT 400 80