7 16
00 07 07 07 07 07 07 07 07 07 07 07 07 07 07 01
12 17 19 19 19 19 19 19 19 19 19 19 19 19 17 12
12 17 16 16 16 16 16 16 16 16 16 16 16 16 17 12
12 17 16 16 16 16 16 16 16 16 16 16 16 16 17 12
12 17 16 16 16 16 16 16 16 16 16 16 16 16 17 12
12 17 16 16 16 16 16 16 16 16 16 16 16 16 17 12
02 07 07 07 07 07 07 07 07 07 07 07 07 07 07 03
1 80 120 
1 280 160
1
EXIT 400 80